...................................................
...................................................
...................................................
...................................................
..................###############..................
..................#................................
..................#................................
..................#................................
..................#................................
..................###############..................
................................#..................
................................#..................
................................#..................
................................#..................
..................###############..................
...................................................
...................................................
...................................................


